file	affiliations	country
paper457.pdf	Electronics and Computer Science, University of-Electronics and Computer Science, University of	Germany-Germany-Germany-UK
paper443.pdf	University of Waterloo-University of Waterloo-University of Waterloo-University of Waterloo-University of St Andrews-University of St Andrews	Canada-Canada-UK
paper325.pdf	Monash University-Monash University-Monash University-Monash University-Monash University-Monash University-University of South-University of South-Monash University-Monash University-Monash University-Monash University	Australia-Australia-Australia-Australia-Australia-Australia-Australia
paper455.pdf	Utrecht University-Utrecht University	Germany-Germany-Netherlands
paper333.pdf	University of Michigan-University of Michigan-University of Michigan-University of Michigan	USA-USA
paper327.pdf	Victoria University of Wellington-Victoria University of Wellington-McGill University-McGill University-McGill University-McGill University	
paper441.pdf	University of Strathclyde-University of Strathclyde-University of Strathclyde-University of Strathclyde	
paper469.pdf	School of Information-University of Michigan-University of Michigan-School of Information-University of Michigan-University of Michigan	USA-USA
paper496.pdf	of Thousands of Students across an Entire School Year-Institute of Cognitive Science-University of Colorado Boulder-University of Colorado Boulder-Institute of Cognitive Science-University of Colorado Boulder-University of Colorado Boulder-Institute of Cognitive Science-University of Colorado Boulder-University of Colorado Boulder	USA-USA-USA
paper482.pdf	Engaging High School Students in Cameroon with-Cornell University-Cornell University-Cornell University-Cornell University-Cornell University-Cornell University-Cornell University-Cornell University	
paper131.pdf	Department of Computer Science,-University of Oxford-University of Oxford-Department of Computer Science,-University of Oxford-University of Oxford-Human Centered Design &-University of Washington-University of Washington-Department of Psychology,-University of Toronto-University of Toronto-Department of Informatics,-King’s College London-Department of Computer Science,-University of Oxford-University of Oxford	United Kingdom-United Kingdom-USA-Canada-United Kingdom-United Kingdom
paper657.pdf	Mixed Reality Lab-University of Nottingham,-University of Nottingham,	UK
paper643.pdf	University of Chicago-University of Chicago-University of Chicago-University of Chicago	Japan-United States-United States
paper125.pdf	Zurich University of the Arts-Zurich University of the Arts-Zurich University of the Arts-Zurich University of the Arts	
paper119.pdf	School of Information-University of Michigan-University of Michigan-School of Information-University of Michigan-University of Michigan-Center-University of Michigan-University of Michigan-University of Michigan Medical-University of Michigan Medical-School-School of Information and-Department of EECS-University of Michigan-University of Michigan	
paper694.pdf	University of Washington-University of Washington-University of Washington-University of Washington-University of Washington-University of Washington	
paper680.pdf	University of California, Berkeley-University of California, Berkeley-University of California, Berkeley-University of California, Berkeley-University of California, Berkeley-University of California, Berkeley	
paper045.pdf	Design Division, California College of the Arts-CITRIS, University of California Berkeley-CITRIS, University of California Berkeley	USA
paper051.pdf	The University of-The University of-University of Oulu,-University of Oulu,-The University of-The University of-University of Oulu,-University of Oulu,-The University of-The University of	Australia-Finland-Australia-Finland-Australia
paper079.pdf	Harvard University-Harvard University-Troy High School-Tufts University-Tufts University-Microsoft Research-Harvard University-Harvard University-Harvard University-Harvard University	
paper086.pdf	Seoul National University-Seoul National University-Seoul National University-Seoul National University-Seoul National University-Seoul National University	Korea-Korea-Korea
paper092.pdf	Institute, Carnegie Mellon University-Institute, Carnegie Mellon University-Institute, Carnegie Mellon University-Institute, Carnegie Mellon University-Institute, Carnegie Mellon University-Institute, Carnegie Mellon University	
paper521.pdf	Weave Lab, IIIT-Delhi-Weave Lab, IIIT-Delhi-Weave Lab, IIIT-Delhi-Weave Lab, IIIT-Delhi	
paper247.pdf	Faculty of Informatics, Masaryk University-Faculty of Informatics, Masaryk University-Faculty of Informatics, Masaryk University-Faculty of Informatics, Masaryk University	
paper253.pdf	University of Edinburgh  Peking University  Columbia University  Microsoft Research-University of Edinburgh  Peking University  Columbia University  Microsoft Research-University of Edinburgh  Peking University  Columbia University  Microsoft Research	
paper535.pdf	Facebook Reality Labs-Facebook Reality Labs-Facebook Reality Labs-Facebook Reality Labs	
paper509.pdf	University of Salzburg-University of Salzburg-University of Salzburg-University of Salzburg	
paper284.pdf	UC Berkeley, California-Adobe Research-Adobe Research-UC Berkeley, California	
paper290.pdf	Department of Media and Information-Michigan State University-Michigan State University-Department of Computer Science and Engineering-Michigan State University-Michigan State University	
paper291.pdf	CNRS – Sorbonne Université-University of Copenhagen-University of Copenhagen-University of Copenhagen-University of Copenhagen	France
paper285.pdf	University of Melbourne-University of Melbourne-University of Melbourne-University of Melbourne-University of Melbourne-University of Melbourne-University of Melbourne-University of Melbourne	Australia-Australia-Australia-Australia
paper508.pdf	University of Trento-University of Trento-University of Trento-University of Trento-Vita-Salute San Raffaele University,-Vita-Salute San Raffaele University,-Free University of Bolzano-Free University of Bolzano	Italy-Italy-Italy-Italy
paper252.pdf	Department of Engineering-University of Cambridge-University of Cambridge-Department of Engineering-University of Cambridge-University of Cambridge-Department of Engineering-University of Cambridge-University of Cambridge	United Kingdom-United Kingdom-United Kingdom
paper534.pdf	Carnegie Mellon University-Carnegie Mellon University-Carnegie Mellon University-Carnegie Mellon University-Carnegie Mellon University-Carnegie Mellon University-Carnegie Mellon University-Carnegie Mellon University	
paper520.pdf	School of Computer Science-University of Waterloo-University of Waterloo-School of Computer Science-University of Waterloo-University of Waterloo-School of Computer Science-University of Waterloo-University of Waterloo	
paper246.pdf	School of Computer Science, University of Waterloo-School of Computer Science, University of Waterloo-School of Computer Science, University of Waterloo	
paper093.pdf	Brigham Young University-Brigham Young University	
paper087.pdf	The University of Tokyo-The University of Tokyo-The University of Tokyo-The University of Tokyo-The University of Tokyo-The University of Tokyo	
paper078.pdf		
paper050.pdf	University of Illinois Urbana-Champaign-University of Illinois Urbana-Champaign-Adobe Research	
paper044.pdf	Clemson University-Clemson University-Indiana University-Indiana University-Indiana University-Indiana University-Indiana University-Indiana University-Indiana University-Indiana University-Indiana University-Indiana University	
paper681.pdf	Hong Kong University of-Hong Kong University of-Hong Kong University of-Hong Kong University of-Zhejiang University-Zhejiang University-Hong Kong University of-Hong Kong University of-Hong Kong University of-Hong Kong University of-Hong Kong University of-Hong Kong University of	
paper695.pdf	University of Lisbon-University of Lisbon-Madeira Interactive Technologies Institute & Universidade-Madeira Interactive Technologies Institute & Universidade-Madeira Interactive Technologies Institute & Universidade-Madeira Interactive Technologies Institute & Universidade-Madeira Interactive Technologies Institute & Universidade-Madeira Interactive Technologies Institute & Universidade-Madeira Interactive Technologies Institute & IST,	Portugal-Portugal-Portugal-Portugal
paper118.pdf	Open Lab, Newcastle University-Open Lab, Newcastle University-Open Lab, Newcastle University-Geography, Politics and Sociology, Newcastle University-Geography, Politics and Sociology, Newcastle University-University of Lapland-University of Lapland-Open Lab, Newcastle University-Open Lab, Newcastle University-Open Lab, Newcastle University	UK-UK-Finland-UK
paper642.pdf	Institute of Service Science-National Tsing Hua University-National Tsing Hua University-Department of Informatics-University of California Irvine-University of California Irvine-Department of Biostatistics-University of Michigan-University of Michigan-School of Information-University of Michigan-University of Michigan-Department of Medicine-University of Michigan-University of Michigan-University of Michigan-University of Michigan-Medical School-Department of Internal Medicine	USA-USA-USA-USA-USA-USA-USA
paper124.pdf	Teachers College-Columbia University-Columbia University	
paper130.pdf	Swansea University-Swansea University-Swansea University-Swansea University-University of St Andrews-University of St Andrews	UK-UK-UK
paper656.pdf	Northwestern University-Northwestern University-Northwestern University-Northwestern University-Northwestern University-Northwestern University-Northwestern University-Northwestern University	
paper483.pdf	INTERACT Lab, University of Sussex-INTERACT Lab, University of Sussex-INTERACT Lab, University of Sussex-INTERACT Lab, University of Sussex-INTERACT Lab, University of Sussex-INTERACT Lab, University of Sussex-INTERACT Lab, University of Sussex-INTERACT Lab, University of Sussex-INTERACT Lab, University of Sussex-University of Bristol-University of Bristol-University of Bristol-University of Bristol-INTERACT Lab, University of Sussex-INTERACT Lab, University of Sussex-INTERACT Lab, University of Sussex	United Kingdom-United Kingdom-United Kingdom-United Kingdom-United Kingdom-United Kingdom
paper497.pdf	Pomona College-Pomona College	USA-USA
